11111
10001
1PC01
1CE01
11111
